arise - arose - arisen - возникать
awake - awoke - awoken - просыпаться
be - was/were - been - быть
bear - bore - borne/born - нести/родить
beat - beat - beaten - бить
become - became - become - становиться
begin - began - begun - начинать
bend - bent - bent - сгибать
bet - bet - bet - держать пари
bid - bid - bid - предлагать цену
bind - bound - bound - связывать
bite - bit - bitten - кусать
bleed - bled - bled - кровоточить
blow - blew - blown - дуть
break - broke - broken - ломать
breed - bred - bred - разводить
bring - brought - brought - приносить
broadcast - broadcast - broadcast - транслировать
build - built - built - строить
burn - burnt/burned - burnt/burned - жечь
burst - burst - burst - разрываться
buy - bought - bought - покупать
cast - cast - cast - бросать (более мягко, в воздух)
catch - caught - caught - ловить
choose - chose - chosen - выбирать
cling - clung - clung - цепляться
come - came - come - приходить
cost - cost - cost - стоить
creep - crept - crept - ползти
cut - cut - cut - резать
deal - dealt - dealt - иметь дело
dig - dug - dug - копать
do - did - done - делать
draw - drew - drawn - рисовать
dream - dreamt/dreamed - dreamt/dreamed - мечтать
drink - drank - drunk - пить
drive - drove - driven - водить
eat - ate - eaten - есть
fall - fell - fallen - падать
feed - fed - fed - кормить
feel - felt - felt - чувствовать
fight - fought - fought - бороться
find - found - found - находить
flee - fled - fled - бежать/избегать (негативное)
fling - flung - flung - бросать (сильно, резко) / метать
fly - flew - flown - летать
forbid - forbade - forbidden - запрещать
forget - forgot - forgotten - забывать
forgive - forgave - forgiven - прощать
freeze - froze - frozen - замораживать
get - got - got/gotten - получать
give - gave - given - давать
go - went - gone - идти
grind - ground - ground - молоть
grow - grew - grown - расти
hang - hung - hung - вешать (объекты)
have - had - had - иметь
hear - heard - heard - слышать
hide - hid - hidden - прятать
hit - hit - hit - ударять
hold - held - held - держать
hurt - hurt - hurt - причинять боль
keep - kept - kept - хранить
know - knew - known - знать
lay - laid - laid - класть
lead - led - led - вести
lean - leant/leaned - leant/leaned - наклоняться
leap - leapt/leaped - leapt/leaped - прыгать
learn - learnt/learned - learnt/learned - учиться
leave - left - left - оставлять
lend - lent - lent - одалживать
let - let - let - позволять
lie - lay - lain - лежать
light - lit - lit - зажигать (огонь, свечу)
lose - lost - lost - терять
make - made - made - делать
mean - meant - meant - значить
meet - met - met - встречать
pay - paid - paid - платить
put - put - put - класть
read - read - read - читать
ride - rode - ridden - ездить верхом
ring - rang - rung - звонить
rise - rose - risen - подниматься (самостоятельно, без внешней силы)
run - ran - run - бежать
say - said - said - говорить
see - saw - seen - видеть
seek - sought - sought - искать
sell - sold - sold - продавать
send - sent - sent - отправлять
set - set - set - устанавливать, ставить что-либо
sew - sewed - sewn/sewed - шить
shake - shook - shaken - трясти
shine - shone - shone - светить
shoot - shot - shot - стрелять
show - showed - shown/showed - показывать
shrink - shrank - shrunk - сжиматься
shut - shut - shut - закрывать
sing - sang - sung - петь
sink - sank - sunk - тонуть
sit - sat - sat - сидеть
sleep - slept - slept - спать
slide - slid - slid - скользить
smell - smelt/smelled - smelt/smelled - пахнуть
speak - spoke - spoken - говорить
speed - sped - sped - ускоряться (о движении)
spend - spent - spent - тратить
spill - spilt/spilled - spilt/spilled - проливать
spin - spun - spun - вращать
spit - spat - spat - плевать
split - split - split - разделять
spread - spread - spread - распространять
spring - sprang - sprung - прыгать (резко как пружина)
stand - stood - stood - стоять
steal - stole - stolen - красть
stick - stuck - stuck - приклеивать
sting - stung - stung - жалить
stink - stank - stunk - вонять
stride - strode - stridden - шагать
strike - struck - struck/stricken - ударять (сильно, внезапно) (3ф поражённый)
string - strung - strung - нанизывать
strive - strove - striven - стремиться
swear - swore - sworn - клясться
sweep - swept - swept - подметать
swim - swam - swum - плавать
swing - swung - swung - качать
take - took - taken - брать
teach - taught - taught - учить
tear - tore - torn - рвать
tell - told - told - рассказывать
think - thought - thought - думать
throw - threw - thrown - бросать
understand - understood - understood - понимать
wake - woke - woken - будить
wear - wore - worn - носить
weep - wept - wept - плакать
win - won - won - выигрывать
wind - wound - wound - заводить (часы, механизм)
write - wrote - written - писать
overcome - overcame - overcome - преодолевать
undertake - undertook - undertaken - предпринимать
upset - upset - upset - расстраивать
withdraw - withdrew - withdrawn - изымать,отступать
withstand - withstood - withstood - выдерживать
wet - wet/wetted - wet/wetted - мочить
